S 1 1 1 1 1 1 1 1
1 1 1 # # # 1 1 1
1 1 1 1 1 1 1 1 1
1 1 # # # # # 1 1
1 1 1 1 1 1 1 1 G
